001111111111111111111
000000000000100010001
111110101010101110101
101000101010101010101
101011111010101011101
101010000010000000101
101111101111111011101
101010100010000000101
101010111010101011101
100010001010101000001
111010111111111110101
100000101010100000101
101111101010101111111
100000001010100000001
111011111010111010101
100000101000000010101
101111101111111110111
100010101000000000001
101010101011101111111
101000000000100000001
111111111111111111100